Map:
------------
------------
--111qq111--
------------
-111----111-
-111-##-111-
-111-22-111-
-111-##-111-
-111----111-
-qqqqqqqqqq-
-qqqqqqqqqq-
------------
------------
------------
------------
------------
------------
------------
------------
------------
------------
------------
------------
------------
Map/

Meta:
Name: LEVEL 1
Time: 300
PowerUp: q
Meta/

Legend:
#) teal-block.png
1) blue-block.png
2) green-block.png
q) darkgreen-block.png
Legend/