Map:
------------
-----qqqqq--
--1111------
-----####---
---22222----
--111-------
------------
------------
-------qqq--
------------
------------
------------
------------
------------
------------
------------
------------
------------
------------
------------
------------
------------
------------
------------
Map/

Meta:
Name: LEVEL 1
Time: 300
PowerUp: 2
Meta/

Legend:
#) teal-block.png
1) blue-block.png
2) green-block.png
q) darkgreen-block.png
Legend/