Map:
--------0000
-----1--0000
-----1--0000
000--1--0000
ddd222222ddd
------------
------------
------------
------------
------------
------------
------------
------------
------------
------------
------------
------------
------------
------------
------------
------------
------------
------------
------------
Map/

Meta:
Name: LEVEL 1
Time: 300
PowerUp: 2
Unbreakable: d
Meta/

Legend:
2) teal-block.png
0) blue-block.png
1) green-block.png
d) darkgreen-block.png
Legend/